# S: Start Position/ Base Station
# D: Delivering Position
# P: Pick-up Station
# 0: Free
# 1: Obstacle
0 0 0 0 0 0 0 0 0 P
0 P 0 0 1 1 1 1 0 0
1 0 0 0 1 0 D 0 0 0
1 0 0 0 1 0 0 0 0 0
1 1 1 0 0 0 0 0 0 0
0 0 1 0 0 0 P 0 1 1
0 0 0 0 0 0 0 0 1 1
S 0 0 0 0 0 0 0 0 0